E_id,rentee_id,previous_unit,current_unit,used_unit,amount,unit_recorded_on
1,1,0,110,110,660,2023-12-31
2,1,110,253,143,858,2024-01-31
3,2,0,104,104,624,2024-01-31
4,1,253,368,115,690,2024-02-18
5,2,104,427,323,1238,2024-02-29
6,2,427,947,520,3120,2024-03-30
7,3,368,557,189,1134,2024-03-30
8,2,947,1487,540,3240,2024-04-16
9,3,557,826,269,1614,2024-04-30
10,3,826,1066,240,1440,2024-05-31
11,4,1487,1631,144,864,2024-05-31